18 10 16
1 1 1 1 1 1 1 1 1 1 1 1 1 1 1 1 1 1 -
1 0 0 0 0 0 0 0 0 0 0 0 0 0 0 0 0 1 -
1 0 0 0 0 0 0 0 0 0 0 0 0 0 1 1 0 1 -
1 0 0 0 0 0 0 0 0 0 0 0 0 0 1 1 0 1 -
1 0 0 0 1 0 0 0 0 0 0 0 0 0 0 0 0 1 -
1 0 0 0 1 4 0 0 0 0 0 0 0 0 0 0 0 1 -
1 0 0 0 1 3 3 3 0 0 0 0 0 0 0 0 0 1 -
1 1 0 0 1 2 2 2 2 1 0 0 0 0 0 0 0 1 -
1 1 1 0 0 0 0 0 0 0 0 0 0 0 0 0 0 1 -
1 1 1 1 1 1 1 1 1 1 1 1 1 1 1 1 1 1 . 